JOUEUR = "P"

CLEFS BLEUE = "f"
CLEFS ROUGE = "g"
CLEFS JAUNE = "h"

BOUTON FIN DU NIVEAU = "A"
PORTE FIN DU NIVEAU = "E"

PORTE BLEUE = "F"
PORTE ROUGE = "G"
PORTE JAUNE = "H"

TOMBE SQUELETTE = "t"
CADAVRE = "T"
TOMBE HAUTE = "u"
TOMBE ETOILE = "U"
TOMBE SANG = "v"

PANNEAU DE CONTROLE = "q"
MUR EN METAL = "Q"
ECRAN VERT = "r"
PALISSADE MARRON MOCHE = "R"
PORTE EN D'ENTREE = "s"

PLATEFORME FINE = "x"
PLATEFORME MOYENNE = "X"
PLATEFORME GRANDE = "y"
PLATFORME STYLE = "Y"

PLATEFORME TRAVERSABLE = "w"

PLATEFORME MOUVANTE DROITE = "M"
PLATEFORME MOUVANTE GAUCHE = "m"

SHOTGUN = "2"
MINIGUN = "3"
TRONCONNEUSE = "4"

PINK = "o"
ZOMBIEMAN = "Z"
IMP = "I"

MEDIKIT = "l"
MUNITION = "a"